advantage=преимущество
application=приложение
approximate=приблизительный
attach=прикреплять
back up=резервное копирование
built-in=встроенный
carbon paper=копировальная бумага
commonly known=общеизвестный
comparison=сравнение
dedicated=преданный
directly=немедленно
dot-matrix printer=матричный принтер
drawback=недостаток
droplets=капельки
employ=использовать
feedback=обратная связь
hardcopy device=печатное устройство
impact printers=ударные принтеры
improvement=улучшение
inappropriate=несоответствующий
ink-jet=струйный принтер
inkless printer=бесцветный принтер
keypad=клавиатура
keystroke=нажатие клавиши
layer=слой
layout=расположение
LCD(Liquid Crystal Display)=Жидкокристаллический дисплей
legal documentations=юридические документы
non-impact printers=бесконтактные принтеры
non-printing features=непечатные функции
peripheral device=периферийное устройство
pixel=пиксель
power-hungry=властолюбивый
precise dots=точные точки
primarily=в первую очередь
raster=растр
resolution=разрешающая способность
reveal=выявить
sales invoice=счет-фактура продажи
sensitive=чувствительный
significant=значительное
simultaneously=одновременно
solid-ink printer=твердотельный принтер
substantial=существенный
sufficient=достаточно
technology=технология
convert=конвертировать
enter=вводить, входить
superimpose=накладывать
transparencies=прозрачные пленки
typewriter=печатная машинка
vector-based artwork=векторное произведение
versatile disk=универсальный диск
visual aid=наглядное пособие
warm-up time=время прогрева
wireless=беспроводной
