abstraction=абстракция
addition=дополнение
arbitrary text files=произвольные текстовые файлы
assembly code=код сборки
assembly language=язык сборки
binary values=бинарные значения
built-in=встроенный
compiler=компилятор
concerned=связанный
concurrency=совпадение
convenient=удобный
debugged=отлаженный
deficiency=недостаток
designate=определять
discretion=усмотрение
ease-to-use=простота в использовании
encapsulation=инкапсуляция
encourage=поощрять
establish=установить
evolve=эволюционировать
executable file=исполняемый файл
execution=исполнение
extension language=язык расширений
facilitate=облегчать
full-fledged application=развившееся приложение
garbage=мусор
heir=наследник
high-level languages=языки высокого уровня
human-like words=слова людей
implement=имплементировать
in order to run=чтобы запустить
inherent cross-platform=свойственный кроссплатформенности
interpreter=интерпретатор
low-level languages=языки низкого уровня
mnemonic=мнемонический
natural languages=естественные языки
notation=нотация
object code=объектный код
object-oriented programming=объектно-ориентированное программирование
permanently=постоянно
problem-oriented languages=проблемно-ориентиованные языки
procedural languages=процедурные языки
query languages=языки запросов
realm=сфера
robust=крепкий
source code=исходный код
specificity=специфичность
standpoint=точка зрения
statement=утверждение
to hide=скрывать
to interface=взаимодействовать
to join=объединять
usability=удобство использования
